1111111111111111111111111111111
10000000000000000001C0000000001
1011111111001111100011111100001
10000000P1000000000000000110001
1111100111011111111111000100001
1C00001000000000000001000000001
1000111100111111100001111111001
10000000001C000011C000000000001
1011111011100000011111011111101
1000000010000000000000010000001
1111000010111111111100010111111
1C000000000000000000000000000E1
1111111111111111111111111111111